############################
#............#.............#
#............#.............#
#....##################....#
#....#................#....#
#............#.............#
#..........#####...........#
#..........................#
#..........................#
#..........#####...........#
#............#.............#
#....#................#....#
#....##################....#
#............#.............#
#............#.............#
############################