############################
#..........................#
#..........................#
#....##################....#
#..........................#
#..........................#
#..........................#
#..........#...............#
#..........#...............#
#..........................#
#..........................#
#..........................#
#....##################....#
#..........................#
#..........................#
############################